........................
........................
...............E........
..............RMMML.....
..............RMMPML....
..............RMMML.....
LLLLLLL.................
LLLLLLL.................
