........................
........................
...............E........
..............RMMML.....
..............RMMPML....
..............RMMML.....
LMMMMMMMMMR.............
LMMMMMMMMMR.............
........................
........................
........................
........................
........................
........................
........................
........................
........................
........................
LMMMMMMMMMR.............


